service_id,monday,tuesday,wednesday,thursday,friday,saturday,sunday,start_date,end_date
"ST_20110701","0","0","0","0","0","1","0","20110701","20120630"
"WD_20110701","1","1","1","1","1","0","0","20110701","20120630"
"WE_20110701","0","0","0","0","0","1","1","20110701","20120630"
"ST_20120701","0","0","0","0","0","1","0","20120701","20170701"
"WD_20120701","1","1","1","1","1","0","0","20120701","20170701"
"WE_20120701","0","0","0","0","0","1","1","20120701","20170701"
